#######
#  O  #
# P@OB#
#  O  #
#######