#######
###O###
## B ##
#OBPBO#
## B ##
###O###
#######